b	Close, fill and stroke path
B	Fill and stroke path
b*	Close, fill and stroke path (even-odd rule)
B*	Fill and stroke path (even-odd rule)
BDC	Begin marked-content sequence
BI	Begin inline image object
BMC	Begin marked-content sequence
BT	Begin text object
BX	Begin compatibility section
c	Curveto
cm	Concat matrix to ctm
CS	Set color space for stroking
cs	Set color space for nonstroking
d	Set line dash pattern
d0	Set glyph width in Type 3 font
d1	Set glyph width and bbox in Type 3 font
Do	Invoke named XObject
DP	Define marked-content point
EI	End inline image object
EMC	End marked-content sequence
ET	End text object
EX	End compatibility section
f	Fill path
F	Fill path (obsolete)
f*	Fill path (even-odd rule)
G	Set gray level for stroking
g	Set gray level for nonstroking
gs	Set parameters from gstate dict
h	Close subpath
i	Set flatness tolerance
ID	Begin inline image data
j	Set line join style
J	Set line cap style
K	Set CMYK color for stroking
k	Set CMYK color for nonstroking
l	Lineto
m	Moveto
M	Set miter limit
MP	Define marked-content point
n	End path without filling or stroking
q	Gstate save
Q	Gstate restore
re	Append rectangle
RG	Set RGB for stroking
rg	Set RGB for nonstroking
ri	Set color rendering intent
s	Close and stroke path
S	Stroke path
SC	Set color for stroking
sc	Set color for nonstroking
SCN	Set color for stroking (special color spaces)
scn	Set color for nonstroking (special color spaces)
sh	Paint area define by shading pattern
T*	Move to start of next line
Tc	Set character spacing
Td	Move text position
TD	Move text position and set leading
Tf	Set text font and size
Tj	Show text
TJ	Show text with glyph positioning
TL	Set text leading
Tm	Set text matrix and text line matrix
Tr	Set text rendering mode
Ts	Set text rise
Tw	Set word spacing
Tz	Set horizontal text scale
v	Curveto (initial point replicated)
w	Set line width
W	Set clip path
W*	Set clip path (even-odd rule)
y	Curveto (final point replicated)
'	Move to next line and show text
"	Set word and char spacing, move to next line and show text

